NO ./images/north.xpm
SO ./images/south.xpm
WE ./images/west.xpm
EA ./images/east.xpm

C 135,206,235
F 34,139,34

111111111111111
101         101
101         101
101     N   101
101         101
101         101
111111111111111












