
NO ./images/north.xpm
SO                 ./images/south.xpm
EA ./images/east.xpm
WE ./images/west.xpm

C 135,206,235 
F 34,139,255








        11111111111111111111111111
        10000000001100000000000001
        1011000001110000000000001
        1001000000000000000000001
111111111011000001110000000000001
100000000011000001110111110111111
11110111111111011100000010001
11110111111111011101010010001
11000000110101011100000010001
10000000000000001100000010001
100000000000000011N1010011111
11011101110101011111011111111
1111111111111111111111111111111
1111111111111111111111111111111
1111 111 1110101 101111010001
1111 111 1111111 111111111001
1111111111111111111111111111111111