
NO ./images/north.xpm

                            SO                 ./images/south.xpm
C 135,206,235 

11111111
100000N1
11111111

EA ./images/east.xpm

WE ./images/west.xpm

F 34,139,255