EA ./images/east.xpm
NO ./images/north.xpm
SO ./images/south.xpm
WE ./images/west.xpm

F 255,0,0
C 0,0,255

                 
1111
100S111111
1000000001
1000111111
11111










